###########
#...++....#
#.######..#
#...+###..#
####...#..#
#@.....#..#
#..#+#.#..#
#..#.#....#
#..+......~
##...#...##
###########