-#########
-##.....+#
-#.......~
-#......##
-##+#+...#
-##......#
-#...#...#
-#......##
-#......@#
-#+.#+...#
-#########
