###########
##...#...+#
#......#..#
#.#.##.#..#
#+.....#..#
##./+.....#
#@...###.##
#.#..+#+.##
#.#.#.#...#
#.......#.#
#..#..#...~
###########
